out_group	Metazoa;.Eumetazoa;.Bilateria;.Protostomia;.Spiralia;.Lophotrochozoa;.Platyhelminthes;.Cestoda;.Eucestoda;.Cyclophyllidea;.Taeniidae;.Echinococcus
fauna_1	Metazoa;.Eumetazoa;.Bilateria;.Protostomia;.Ecdysozoa;.Panarthropoda;.Arthropoda;.Mandibulata;.Pancrustacea;.Hexapoda;.Collembola;.Poduromorpha;.Poduroidea;.Poduridae;.Podura
fauna_2	Metazoa;.Eumetazoa;.Bilateria;.Protostomia;.Ecdysozoa;.Panarthropoda;.Arthropoda;.Chelicerata;.Arachnida;.Acari;.Acariformes;.Trombidiformes;.Prostigmata;.Eleutherengona;.Raphignathae;.Raphignathoidea;.Raphignathidae
fauna_3	Metazoa;.Eumetazoa;.Bilateria;.Protostomia;.Ecdysozoa;.Panarthropoda;.Arthropoda;.Chelicerata;.Arachnida;.Acari;.Acariformes;.Sarcoptiformes;.Oribatida;.Mixonomata;.Phthiracaroidea;.Steganacaridae;.Steganacarus
fauna_4	Metazoa;.Eumetazoa;.Bilateria;.Protostomia;.Ecdysozoa;.Panarthropoda;.Arthropoda;.Chelicerata;.Arachnida;.Acari;.Acariformes;.Trombidiformes;.Prostigmata;.Eleutherengona;.Raphignathae;.Raphignathoidea;.Cryptognathidae
fauna_5	Metazoa;.Eumetazoa;.Bilateria;.Protostomia;.Ecdysozoa;.Panarthropoda;.Arthropoda;.Chelicerata;.Arachnida;.Acari;.Acariformes;.Trombidiformes;.Prostigmata;.Anystina;.Parasitengona;.Erythraeoidea;.Erythraeidae
fauna_6	Metazoa;.Eumetazoa;.Bilateria;.Protostomia;.Ecdysozoa;.Panarthropoda;.Arthropoda;.Chelicerata;.Arachnida;.Acari;.Acariformes;.Trombidiformes;.Prostigmata;.Eleutherengona;.Heterostigmata;.Pygmephoroidea;.Scutacaridae
fauna_7	Metazoa;.Eumetazoa;.Bilateria;.Protostomia;.Ecdysozoa;.Panarthropoda;.Arthropoda;.Mandibulata;.Pancrustacea;.Hexapoda;.Collembola;.Poduromorpha;.Poduroidea;.Onychiuridae;.Onychiurinae;.Onychiurus
fauna_8	Metazoa;.Eumetazoa;.Bilateria;.Protostomia;.Ecdysozoa;.Panarthropoda;.Arthropoda;.Mandibulata;.Pancrustacea;.Hexapoda;.Collembola;.Poduromorpha;.Poduroidea;.Onychiuridae
fauna_9	Metazoa;.Eumetazoa;.Bilateria;.Protostomia;.Ecdysozoa;.Panarthropoda;.Arthropoda;.Chelicerata;.Arachnida;.Acari;.Acariformes;.Sarcoptiformes;.Oribatida;.Brachypylina;.Gustavioidea;.Gustaviidae;.Gustavia
fauna_10	Metazoa;.Eumetazoa;.Bilateria;.Protostomia;.Ecdysozoa;.Panarthropoda;.Arthropoda;.Chelicerata;.Arachnida;.Acari;.Acariformes;.Trombidiformes;.Prostigmata;.Anystina;.Anystae;.Caeculoidea;.Caeculidae
fauna_11	Metazoa;.Eumetazoa;.Bilateria;.Protostomia;.Ecdysozoa;.Panarthropoda;.Arthropoda;.Mandibulata;.Pancrustacea;.Hexapoda;.Insecta;.Dicondylia;.Pterygota;.Neoptera;.Paraneoptera;.Psocodea;.Psocoptera;.Trogiomorpha;.Lepidopsocidae
fauna_12	Metazoa;.Eumetazoa;.Bilateria;.Protostomia;.Ecdysozoa;.Panarthropoda;.Arthropoda;.Mandibulata;.Pancrustacea;.Hexapoda;.Collembola;.Poduromorpha;.Poduroidea;.Neanuridae
fauna_13	Metazoa;.Eumetazoa;.Bilateria;.Protostomia;.Ecdysozoa;.Panarthropoda;.Arthropoda;.Mandibulata;.Myriapoda;.Symphyla;.Scolopendrellidae
fauna_14	Metazoa;.Eumetazoa;.Bilateria;.Protostomia;.Ecdysozoa;.Panarthropoda;.Arthropoda;.Mandibulata;.Pancrustacea;.Hexapoda;.Insecta;.Dicondylia;.Pterygota;.Neoptera;.Holometabola;.Hymenoptera;.Apocrita;.Aculeata;.Formicoidea;.Formicidae;.Formicinae
fauna_15	Metazoa;.Eumetazoa;.Bilateria;.Protostomia;.Ecdysozoa;.Panarthropoda;.Arthropoda;.Chelicerata;.Arachnida;.Acari;.Acariformes;.Sarcoptiformes;.Oribatida;.Brachypylina;.Oripodoidea;.Oribatulidae;.Oribatula
fauna_16	Metazoa;.Eumetazoa;.Bilateria;.Protostomia;.Ecdysozoa;.Panarthropoda;.Arthropoda;.Mandibulata;.Pancrustacea;.Hexapoda;.Collembola;.Entomobryomorpha;.Isotomoidea;.Isotomidae
fauna_17	Metazoa;.Eumetazoa;.Bilateria;.Protostomia;.Ecdysozoa;.Panarthropoda;.Arthropoda;.Chelicerata;.Arachnida;.Acari;.Acariformes;.Sarcoptiformes;.Astigmata;.Psoroptidia;.Sarcoptoidea;.Sarcoptidae;.Sarcoptinae;.Sarcoptes
fauna_18	Metazoa;.Eumetazoa;.Bilateria;.Protostomia;.Ecdysozoa;.Panarthropoda;.Arthropoda;.Mandibulata;.Pancrustacea;.Hexapoda;.Insecta;.Dicondylia;.Pterygota;.Neoptera;.Paraneoptera;.Psocodea;.Psocoptera;.Psocomorpha;.Psocetae;.Psocidae
fauna_19	Metazoa;.Eumetazoa;.Bilateria;.Protostomia;.Ecdysozoa;.Panarthropoda;.Arthropoda;.Mandibulata;.Pancrustacea;.Hexapoda;.Insecta;.Dicondylia;.Pterygota;.Neoptera;.Paraneoptera;.Thysanoptera;.Tubulifera;.Phlaeothripoidea;.Phlaeothripidae
fauna_20	Metazoa;.Eumetazoa;.Bilateria;.Protostomia;.Ecdysozoa;.Panarthropoda;.Arthropoda;.Chelicerata;.Arachnida;.Acari;.Acariformes;.Sarcoptiformes;.Oribatida;.Brachypylina;.Oripodoidea;.Oribatulidae
fauna_21	Metazoa;.Eumetazoa;.Bilateria;.Protostomia;.Ecdysozoa;.Panarthropoda;.Arthropoda;.Mandibulata;.Pancrustacea;.Hexapoda;.Collembola;.Poduromorpha;.Poduroidea;.Neanuridae;.Pseudachorutinae;.Pseudachorutes
fauna_22	Metazoa;.Eumetazoa;.Bilateria;.Protostomia;.Ecdysozoa;.Panarthropoda;.Arthropoda;.Mandibulata;.Pancrustacea;.Hexapoda;.Insecta;.Dicondylia;.Pterygota;.Neoptera;.Paraneoptera;.Psocodea;.Psocoptera;.Psocomorpha;.Psocetae;.Hemipsocidae
fauna_23	Metazoa;.Eumetazoa;.Bilateria;.Protostomia;.Lophotrochozoa;.Annelida;.Clitellata;.Oligochaeta;.Enchytraeida;.Enchytraeidae
fauna_24	Metazoa;.Eumetazoa;.Bilateria;.Protostomia;.Ecdysozoa;.Panarthropoda;.Arthropoda;.Mandibulata;.Pancrustacea;.Hexapoda;.Collembola;.Entomobryomorpha;.Entomobryoidea;.Paronellidae
fauna_25	Metazoa;.Eumetazoa;.Bilateria;.Protostomia;.Ecdysozoa;.Panarthropoda;.Arthropoda;.Chelicerata;.Arachnida;.Araneae;.Araneomorphae;.Entelegynae;.RTA clade;.Dictynoidea;.Dictynidae
fauna_26	Metazoa;.Eumetazoa;.Bilateria;.Protostomia;.Ecdysozoa;.Panarthropoda;.Arthropoda;.Chelicerata;.Arachnida;.Acari;.Acariformes;.Sarcoptiformes;.Oribatida;.Brachypylina;.Oripodoidea;.Oribatulidae;.Phauloppia
fauna_27	Metazoa;.Eumetazoa;.Bilateria;.Protostomia;.Ecdysozoa;.Panarthropoda;.Arthropoda;.Chelicerata;.Arachnida;.Acari;.Acariformes;.Trombidiformes;.Prostigmata;.Eleutherengona;.Raphignathae;.Tetranychoidea;.Tetranychidae
fauna_28	Metazoa;.Eumetazoa;.Bilateria;.Protostomia;.Ecdysozoa;.Panarthropoda;.Arthropoda;.Chelicerata;.Arachnida;.Araneae;.Araneomorphae;.Entelegynae;.RTA clade;.Agelenidae
fauna_29	Metazoa;.Eumetazoa;.Bilateria;.Protostomia;.Ecdysozoa;.Panarthropoda;.Arthropoda;.Mandibulata;.Pancrustacea;.Hexapoda;.Insecta;.Dicondylia;.Pterygota;.Neoptera;.Holometabola;.Hymenoptera;.Apocrita;.Aculeata;.Formicoidea;.Formicidae;.Ponerinae
fauna_30	Metazoa;.Eumetazoa;.Bilateria;.Protostomia;.Ecdysozoa;.Panarthropoda;.Arthropoda;.Chelicerata;.Arachnida;.Acari;.Acariformes;.Sarcoptiformes;.Oribatida;.Desmonomata;.Crotonioidea;.Nothridae
fauna_31	Metazoa;.Eumetazoa;.Bilateria;.Protostomia;.Ecdysozoa;.Panarthropoda;.Arthropoda;.Chelicerata;.Arachnida;.Araneae;.Araneomorphae;.Entelegynae;.RTA clade;.Dionycha;.Thomisidae
fauna_32	Metazoa;.Eumetazoa;.Bilateria;.Protostomia;.Ecdysozoa;.Panarthropoda;.Arthropoda;.Mandibulata;.Myriapoda;.Chilopoda;.Pleurostigmophora;.Epimorpha;.Geophilomorpha;.Geophilidae
fauna_33	Metazoa;.Eumetazoa;.Bilateria;.Protostomia;.Ecdysozoa;.Panarthropoda;.Arthropoda;.Mandibulata;.Pancrustacea;.Hexapoda;.Diplura;.Dicellurata;.Japygoidea;.Japygidae
fauna_34	Metazoa;.Eumetazoa;.Bilateria;.Protostomia;.Ecdysozoa;.Panarthropoda;.Arthropoda;.Mandibulata;.Pancrustacea;.Hexapoda;.Insecta;.Dicondylia;.Pterygota;.Neoptera;.Paraneoptera;.Psocodea;.Psocoptera;.Psocomorpha;.Homilopsocidea;.Peripsocoidea;.Peripsocidae
fauna_35	Metazoa;.Eumetazoa;.Bilateria;.Protostomia;.Ecdysozoa;.Panarthropoda;.Arthropoda;.Chelicerata;.Arachnida;.Acari;.Acariformes;.Sarcoptiformes;.Oribatida;.Brachypylina;.Gymnodamaeoidea;.Gymnodamaeidae
fauna_36	Metazoa;.Eumetazoa;.Bilateria;.Protostomia;.Ecdysozoa;.Panarthropoda;.Arthropoda;.Chelicerata;.Arachnida;.Acari;.Acariformes;.Trombidiformes;.Prostigmata;.Eupodina;.Bdelloidea;.Cunaxidae
fauna_37	Metazoa;.Eumetazoa;.Bilateria;.Protostomia;.Ecdysozoa;.Panarthropoda;.Arthropoda;.Mandibulata;.Pancrustacea;.Hexapoda;.Collembola;.Entomobryomorpha;.Entomobryoidea;.Orchesellidae;.Orchesellinae;.Orchesella
fauna_38	Metazoa;.Eumetazoa;.Bilateria;.Protostomia;.Ecdysozoa;.Panarthropoda;.Arthropoda;.Mandibulata;.Pancrustacea;.Hexapoda;.Insecta;.Dicondylia;.Pterygota;.Neoptera;.Paraneoptera;.Psocodea;.Psocoptera;.Troctomorpha;.Nanopsocetae;.Sphaeropsocidae
fauna_39	Metazoa;.Eumetazoa;.Bilateria;.Protostomia;.Ecdysozoa;.Panarthropoda;.Arthropoda;.Mandibulata;.Pancrustacea;.Hexapoda;.Insecta;.Dicondylia;.Pterygota;.Neoptera;.Polyneoptera;.Dictyoptera;.Blattodea;.Blattoidea;.Termitoidae;.Kalotermitidae
fauna_40	Metazoa;.Eumetazoa;.Bilateria;.Protostomia;.Ecdysozoa;.Panarthropoda;.Arthropoda;.Chelicerata;.Arachnida;.Araneae;.Araneomorphae;.Entelegynae;.RTA clade;.Dionycha;.Corinnidae
fauna_41	Metazoa;.Eumetazoa;.Bilateria;.Protostomia;.Ecdysozoa;.Panarthropoda;.Arthropoda;.Mandibulata;.Pancrustacea;.Hexapoda;.Collembola;.Entomobryomorpha;.Entomobryoidea;.Entomobryidae;.Orchesellinae;.Orchesellides
fauna_42	Metazoa;.Eumetazoa;.Bilateria;.Protostomia;.Ecdysozoa;.Panarthropoda;.Arthropoda;.Mandibulata;.Pancrustacea;.Hexapoda;.Insecta;.Dicondylia;.Pterygota;.Neoptera;.Holometabola;.Diptera;.Nematocera;.Culicomorpha;.Culicoidea;.Culicidae
fauna_43	Metazoa;.Eumetazoa;.Bilateria;.Protostomia;.Ecdysozoa;.Panarthropoda;.Arthropoda;.Mandibulata;.Pancrustacea;.Hexapoda;.Insecta;.Dicondylia;.Pterygota;.Neoptera;.Paraneoptera;.Hemiptera;.Prosorrhyncha;.Heteroptera;.Euheteroptera;.Dipsocoromorpha;.Schizopteridae
fauna_44	Metazoa;.Eumetazoa;.Bilateria;.Protostomia;.Ecdysozoa;.Panarthropoda;.Arthropoda;.Chelicerata;.Arachnida;.Acari;.Acariformes;.Sarcoptiformes;.Oribatida;.Brachypylina;.Gustavioidea;.Liacaridae;.Liacarus
fauna_45	Metazoa;.Eumetazoa;.Bilateria;.Protostomia;.Ecdysozoa;.Panarthropoda;.Arthropoda;.Chelicerata;.Arachnida;.Acari;.Acariformes;.Sarcoptiformes;.Oribatida;.Brachypylina;.Licneremaeoidea;.Scutoverticidae;.Scutovertex
fauna_46	Metazoa;.Eumetazoa;.Bilateria;.Protostomia;.Ecdysozoa;.Panarthropoda;.Arthropoda;.Chelicerata;.Arachnida;.Acari;.Acariformes;.Trombidiformes;.Prostigmata;.Eleutherengona;.Raphignathae;.Raphignathoidea;.Stigmaeidae
fauna_47	Metazoa;.Eumetazoa;.Bilateria;.Protostomia;.Ecdysozoa;.Panarthropoda;.Arthropoda;.Chelicerata;.Arachnida;.Acari;.Acariformes;.Trombidiformes;.Prostigmata;.Eupodina;.Eupodoidea;.Penthalodidae
fauna_48	Metazoa;.Eumetazoa;.Bilateria;.Protostomia;.Ecdysozoa;.Panarthropoda;.Arthropoda;.Chelicerata;.Arachnida;.Acari;.Parasitiformes;.Mesostigmata;.Monogynaspida;.Gamasina;.Rhodacaroidea;.Rhodacaridae
fauna_49	Metazoa;.Eumetazoa;.Bilateria;.Protostomia;.Ecdysozoa;.Panarthropoda;.Arthropoda;.Chelicerata;.Arachnida;.Araneae;.Araneomorphae;.Entelegynae;.Eresoidea;.Oecobiidae
fauna_50	Metazoa;.Eumetazoa;.Bilateria;.Protostomia;.Ecdysozoa;.Panarthropoda;.Arthropoda;.Chelicerata;.Arachnida;.Araneae;.Araneomorphae;.Entelegynae;.RTA clade;.Dionycha;.Selenopidae
fauna_51	Metazoa;.Eumetazoa;.Bilateria;.Protostomia;.Ecdysozoa;.Panarthropoda;.Arthropoda;.Chelicerata;.Arachnida;.Araneae;.Mesothelae;.Liphistiidae
fauna_52	Metazoa;.Eumetazoa;.Bilateria;.Protostomia;.Ecdysozoa;.Panarthropoda;.Arthropoda;.Chelicerata;.Arachnida;.Araneae;.Mygalomorphae;.Atypidae
fauna_53	Metazoa;.Eumetazoa;.Bilateria;.Protostomia;.Ecdysozoa;.Panarthropoda;.Arthropoda;.Mandibulata;.Myriapoda;.Diplopoda;.Helminthomorpha;.Spirobolida;.Spirobolidae
fauna_54	Metazoa;.Eumetazoa;.Bilateria;.Protostomia;.Ecdysozoa;.Panarthropoda;.Arthropoda;.Mandibulata;.Pancrustacea;.Hexapoda;.Collembola;.Entomobryomorpha;.Entomobryoidea;.Orchesellidae
fauna_55	Metazoa;.Eumetazoa;.Bilateria;.Protostomia;.Ecdysozoa;.Panarthropoda;.Arthropoda;.Mandibulata;.Pancrustacea;.Hexapoda;.Collembola;.Entomobryomorpha;.Entomobryoidea;.Orchesellidae;.Orchesellinae;.Orchesella
fauna_56	Metazoa;.Eumetazoa;.Bilateria;.Protostomia;.Ecdysozoa;.Panarthropoda;.Arthropoda;.Mandibulata;.Pancrustacea;.Hexapoda;.Diplura;.Rhabdura;.Campodeoidea;.Campodeidae
fauna_57	Metazoa;.Eumetazoa;.Bilateria;.Protostomia;.Ecdysozoa;.Panarthropoda;.Arthropoda;.Mandibulata;.Pancrustacea;.Hexapoda;.Insecta;.Dicondylia;.Pterygota;.Neoptera;.Holometabola;.Hymenoptera;.Apocrita;.Aculeata;.Formicoidea;.Formicidae;.Pseudomyrmecinae
fauna_58	Metazoa;.Eumetazoa;.Bilateria;.Protostomia;.Ecdysozoa;.Panarthropoda;.Arthropoda;.Mandibulata;.Pancrustacea;.Hexapoda;.Insecta;.Dicondylia;.Pterygota;.Neoptera;.Paraneoptera;.Hemiptera;.Prosorrhyncha;.Heteroptera;.Euheteroptera;.Neoheteroptera;.Panheteroptera;.Pentatomomorpha;.Pentatomoidea;.Cydnidae
fauna_59	Metazoa;.Eumetazoa;.Bilateria;.Protostomia;.Ecdysozoa;.Panarthropoda;.Arthropoda;.Mandibulata;.Pancrustacea;.Hexapoda;.Insecta;.Dicondylia;.Pterygota;.Neoptera;.Paraneoptera;.Psocodea;.Psocoptera;.Psocomorpha;.Homilopsocidea;.Lachesilloidea;.Ectopsocidae
fauna_60	Metazoa;.Eumetazoa;.Bilateria;.Protostomia;.Ecdysozoa;.Panarthropoda;.Arthropoda;.Mandibulata;.Pancrustacea;.Hexapoda;.Insecta;.Dicondylia;.Pterygota;.Neoptera;.Paraneoptera;.Psocodea;.Psocoptera;.Psocomorpha;.Psocetae;.Myopsocidae
fauna_61	Metazoa;.Eumetazoa;.Bilateria;.Protostomia;.Ecdysozoa;.Panarthropoda;.Arthropoda;.Mandibulata;.Pancrustacea;.Hexapoda;.Insecta;.Dicondylia;.Pterygota;.Neoptera;.Polyneoptera;.Dictyoptera;.Blattodea;.Blattoidea;.Blattidae
fauna_62	Metazoa;.Eumetazoa;.Bilateria;.Protostomia;.Ecdysozoa;.Panarthropoda;.Arthropoda;.Chelicerata;.Arachnida;.Acari;.Acariformes;.Sarcoptiformes;.Oribatida;.Brachypylina;.Achipterioidea;.Achipteriidae
fauna_63	Metazoa;.Eumetazoa;.Bilateria;.Protostomia;.Ecdysozoa;.Panarthropoda;.Arthropoda;.Chelicerata;.Arachnida;.Acari;.Acariformes;.Sarcoptiformes;.Oribatida;.Brachypylina;.Ceratozetoidea;.Ceratozetidae
fauna_64	Metazoa;.Eumetazoa;.Bilateria;.Protostomia;.Ecdysozoa;.Panarthropoda;.Arthropoda;.Chelicerata;.Arachnida;.Acari;.Acariformes;.Sarcoptiformes;.Oribatida;.Brachypylina;.Ceratozetoidea;.Mycobatidae
fauna_65	Metazoa;.Eumetazoa;.Bilateria;.Protostomia;.Ecdysozoa;.Panarthropoda;.Arthropoda;.Chelicerata;.Arachnida;.Acari;.Acariformes;.Sarcoptiformes;.Oribatida;.Brachypylina;.Oribatelloidea;.Oribatellidae
fauna_66	Metazoa;.Eumetazoa;.Bilateria;.Protostomia;.Ecdysozoa;.Panarthropoda;.Arthropoda;.Chelicerata;.Arachnida;.Acari;.Acariformes;.Trombidiformes;.Prostigmata;.Eleutherengona;.Raphignathae;.Tetranychoidea;.Tetranychidae
fauna_67	Metazoa;.Eumetazoa;.Bilateria;.Protostomia;.Ecdysozoa;.Panarthropoda;.Arthropoda;.Chelicerata;.Arachnida;.Acari;.Parasitiformes;.Mesostigmata;.Monogynaspida;.Gamasina;.Ascoidea;.Ascidae
fauna_68	Metazoa;.Eumetazoa;.Bilateria;.Protostomia;.Ecdysozoa;.Panarthropoda;.Arthropoda;.Chelicerata;.Arachnida;.Araneae;.Araneomorphae;.Entelegynae;.RTA clade;.Dionycha;.Trochanteriidae
fauna_69	Metazoa;.Eumetazoa;.Bilateria;.Protostomia;.Ecdysozoa;.Panarthropoda;.Arthropoda;.Mandibulata;.Pancrustacea;.Hexapoda;.Insecta;.Dicondylia;.Pterygota;.Neoptera;.Holometabola;.Amphiesmenoptera;.Lepidoptera;.Glossata;.Neolepidoptera;.Heteroneura;.Ditrysia;.Obtectomera;.Noctuoidea;.Noctuidae;.Noctuinae;.Athetis
fauna_70	Metazoa;.Eumetazoa;.Bilateria;.Protostomia;.Ecdysozoa;.Panarthropoda;.Arthropoda;.Mandibulata;.Pancrustacea;.Hexapoda;.Insecta;.Dicondylia;.Pterygota;.Neoptera;.Holometabola;.Amphiesmenoptera;.Lepidoptera;.Glossata;.Neolepidoptera;.Heteroneura;.Ditrysia;.Obtectomera;.Noctuoidea;.Noctuidae
fauna_71	Metazoa;.Eumetazoa;.Bilateria;.Protostomia;.Ecdysozoa;.Panarthropoda;.Arthropoda;.Mandibulata;.Pancrustacea;.Hexapoda;.Insecta;.Dicondylia;.Pterygota;.Neoptera;.Holometabola;.Coleoptera;.Polyphaga;.Cucujiformia;.Cucujoidea;.Cryptophagidae
fauna_72	Metazoa;.Eumetazoa;.Bilateria;.Protostomia;.Ecdysozoa;.Panarthropoda;.Arthropoda;.Mandibulata;.Pancrustacea;.Hexapoda;.Insecta;.Dicondylia;.Pterygota;.Neoptera;.Holometabola;.Coleoptera;.Polyphaga;.Staphyliniformia;.Staphylinoidea;.Staphylinidae
fauna_73	Metazoa;.Eumetazoa;.Bilateria;.Protostomia;.Ecdysozoa;.Panarthropoda;.Arthropoda;.Mandibulata;.Pancrustacea;.Hexapoda;.Insecta;.Dicondylia;.Pterygota;.Neoptera;.Holometabola;.Diptera;.Nematocera;.Bibionomorpha;.Pachyneuroidea;.Pachyneuridae
fauna_74	Metazoa;.Eumetazoa;.Bilateria;.Protostomia;.Ecdysozoa;.Panarthropoda;.Arthropoda;.Mandibulata;.Pancrustacea;.Hexapoda;.Insecta;.Dicondylia;.Pterygota;.Neoptera;.Paraneoptera;.Hemiptera;.Prosorrhyncha;.Heteroptera;.Euheteroptera;.Neoheteroptera;.Panheteroptera;.Pentatomomorpha;.Pentatomoidea;.Pentatomidae
fauna_75	Metazoa;.Eumetazoa;.Bilateria;.Protostomia;.Ecdysozoa;.Panarthropoda;.Arthropoda;.Mandibulata;.Pancrustacea;.Hexapoda;.Insecta;.Dicondylia;.Pterygota;.Neoptera;.Paraneoptera;.Psocodea;.Psocoptera;.Troctomorpha;.Amphientometae;.Amphientomidae
fauna_76	Metazoa;.Eumetazoa;.Bilateria;.Protostomia;.Ecdysozoa;.Panarthropoda;.Arthropoda;.Mandibulata;.Pancrustacea;.Hexapoda;.Insecta;.Dicondylia;.Pterygota;.Neoptera;.Polyneoptera;.Dictyoptera;.Blattodea;.Blattoidea;.Termitoidae;.Rhinotermitidae
fauna_77	Metazoa;.Eumetazoa;.Bilateria;.Protostomia;.Ecdysozoa;.Panarthropoda;.Arthropoda;.Mandibulata;.Pancrustacea;.Hexapoda;.Protura;.Eosentomata;.Eosentomidae
